Rk,Player,Pos,Age,Tm,G,GS,MP,FG,FGA,FG%,3P,3PA,3P%,2P,2PA,2P%,eFG%,FT,FTA,FT%,ORB,DRB,TRB,AST,STL,BLK,TOV,PF,PTS
1,Alex Abrines\abrinal01,SG,24,OKC,24,3,417,40,104,.385,25,70,.357,15,34,.441,.505,15,19,.789,9,28,37,10,15,2,12,50,120
2,Quincy Acy\acyqu01,PF,27,BRK,21,0,365,30,97,.309,25,78,.321,5,19,.263,.438,22,26,.846,10,67,77,13,7,4,22,42,107
3,Steven Adams\adamsst01,C,24,OKC,23,23,728,133,206,.646,0,0,,133,206,.646,.646,48,75,.640,108,88,196,18,29,23,39,64,314
4,Bam Adebayo\adebaba01,C,20,MIA,17,6,271,36,59,.610,0,0,,36,59,.610,.610,23,31,.742,24,42,66,6,14,12,11,31,95
5,Arron Afflalo\afflaar01,SG,32,ORL,22,2,300,20,57,.351,6,25,.240,14,32,.438,.404,10,14,.714,3,32,35,11,1,4,8,25,56
6,Cole Aldrich\aldrico01,C,29,MIN,5,0,10,0,2,.000,0,0,,0,2,.000,.000,1,2,.500,0,1,1,1,1,0,0,2,1
7,LaMarcus Aldridge\aldrila01,PF,32,SAS,27,27,907,235,474,.496,16,43,.372,219,431,.508,.513,126,148,.851,90,134,224,58,14,31,41,65,612
8,Jarrett Allen\allenja01,C,19,BRK,18,0,299,38,69,.551,1,2,.500,37,67,.552,.558,18,25,.720,26,42,68,9,10,18,8,32,95
9,Kadeem Allen\allenka01,SG,25,BOS,1,0,5,0,1,.000,0,1,.000,0,0,,.000,1,2,.500,1,1,2,0,0,0,1,0,1
10,Tony Allen\allento01,SG,36,NOP,22,0,273,44,91,.484,4,12,.333,40,79,.506,.505,11,21,.524,20,27,47,9,11,3,19,49,103
11,Al-Farouq Aminu\aminual01,PF,27,POR,13,11,382,43,96,.448,26,56,.464,17,40,.425,.583,12,14,.857,18,73,91,17,8,12,15,24,124
12,Justin Anderson\anderju01,SF,24,PHI,10,0,126,18,48,.375,9,26,.346,9,22,.409,.469,5,7,.714,10,17,27,3,3,1,4,19,50
13,Kyle Anderson\anderky01,SF,24,SAS,23,23,631,80,156,.513,4,11,.364,76,145,.524,.526,40,53,.755,31,106,137,70,27,19,30,37,204
14,Ryan Anderson\anderry01,PF,29,HOU,24,23,682,99,213,.465,67,162,.414,32,51,.627,.622,22,27,.815,31,95,126,17,7,9,22,47,287
15,Ike Anigbogu\anigbik01,C,19,IND,6,0,17,1,5,.200,0,0,,1,5,.200,.200,2,2,1.000,2,2,4,0,1,1,2,1,4
16,Giannis Antetokounmpo\antetgi01,PF,23,MIL,24,24,900,262,480,.546,11,40,.275,251,440,.570,.557,181,234,.774,49,200,249,108,41,39,71,88,716
17,Carmelo Anthony\anthoca01,SF,33,OKC,25,25,820,164,406,.404,51,151,.338,113,255,.443,.467,70,91,.769,20,141,161,40,21,18,38,68,449
18,OG Anunoby\anunoog01,SF,20,TOR,25,13,507,61,123,.496,29,67,.433,32,56,.571,.614,14,22,.636,16,33,49,20,22,1,14,51,165
19,Ryan Arcidiacono\arcidry01,PG,23,CHI,1,0,5,0,2,.000,0,2,.000,0,0,,.000,0,0,,0,0,0,1,0,0,0,1,0
20,Trevor Ariza\arizatr01,SF,32,HOU,23,23,787,90,204,.441,60,153,.392,30,51,.588,.588,25,27,.926,13,88,101,44,38,5,22,44,265
21,Darrell Arthur\arthuda01,PF,29,DEN,4,0,38,3,13,.231,1,9,.111,2,4,.500,.269,0,0,,1,4,5,1,2,0,7,6,7
22,Omer Asik\asikom01,C,31,NOP,7,0,70,5,11,.455,0,0,,5,11,.455,.455,1,2,.500,3,18,21,2,0,0,2,5,11
23,D.J. Augustin\augusdj01,PG,30,ORL,21,6,425,55,117,.470,22,53,.415,33,64,.516,.564,43,50,.860,5,33,38,74,18,0,33,32,175
24,Luke Babbitt\babbilu01,SF,28,ATL,24,9,459,66,134,.493,40,86,.465,26,48,.542,.642,10,15,.667,4,62,66,19,7,4,14,39,182
25,Dwayne Bacon\bacondw01,SG,22,CHO,25,6,436,39,106,.368,10,29,.345,29,77,.377,.415,8,11,.727,1,82,83,20,8,2,14,36,96
26,Ron Baker\bakerro01,SG,24,NYK,9,0,130,7,18,.389,5,10,.500,2,8,.250,.528,12,17,.706,0,5,5,24,10,1,9,10,31
27,Lonzo Ball\balllo01,PG,20,LAL,26,26,861,91,278,.327,32,124,.258,59,154,.383,.385,18,37,.486,36,143,179,183,36,25,66,56,232
28,J.J. Barea\bareajo01,PG,33,DAL,28,1,631,123,286,.430,53,136,.390,70,150,.467,.523,42,55,.764,7,80,87,151,15,1,57,42,341
29,Harrison Barnes\barneha02,PF,25,DAL,28,28,982,189,427,.443,32,98,.327,157,329,.477,.480,106,126,.841,32,175,207,57,20,3,50,40,516
30,Will Barton\bartowi01,SG,27,DEN,27,8,848,155,331,.468,56,137,.409,99,194,.510,.553,56,79,.709,23,121,144,94,31,15,47,54,422
31,Nicolas Batum\batumni01,SG,29,CHO,12,12,353,44,118,.373,11,49,.224,33,69,.478,.419,22,27,.815,7,45,52,53,11,4,25,15,121
32,Jerryd Bayless\bayleje01,SG,29,PHI,21,8,557,63,153,.412,31,84,.369,32,69,.464,.513,27,33,.818,7,45,52,37,14,3,28,51,184
33,Aron Baynes\baynear01,C,31,BOS,29,18,514,69,140,.493,0,4,.000,69,136,.507,.493,29,41,.707,54,99,153,25,10,18,31,63,167
34,Kent Bazemore\bazemke01,SG,28,ATL,27,27,774,110,276,.399,40,105,.381,70,171,.409,.471,74,91,.813,12,111,123,98,50,14,68,61,334
35,Bradley Beal\bealbr01,SG,24,WAS,27,27,943,232,511,.454,59,168,.351,173,343,.504,.512,124,156,.795,22,84,106,89,30,13,68,52,647
36,Malik Beasley\beaslma01,SG,21,DEN,24,0,253,34,81,.420,11,35,.314,23,46,.500,.488,10,16,.625,8,33,41,16,4,2,13,18,89
37,Michael Beasley\beaslmi01,PF,29,NYK,21,4,323,77,149,.517,3,13,.231,74,136,.544,.527,20,31,.645,23,52,75,19,3,7,40,33,177
38,Marco Belinelli\belinma01,SG,31,ATL,27,0,686,106,265,.400,53,139,.381,53,126,.421,.500,58,61,.951,5,58,63,66,28,1,30,21,323
39,Jordan Bell\belljo01,C,23,GSW,22,3,248,46,62,.742,0,0,,46,62,.742,.742,2,4,.500,23,45,68,24,12,23,16,35,94
40,DeAndre' Bembry\bembrde01,SF,23,ATL,13,0,234,29,74,.392,5,15,.333,24,59,.407,.426,12,19,.632,5,29,34,21,11,7,26,21,75
41,Dragan Bender\bendedr01,PF,20,PHO,29,1,580,50,135,.370,32,90,.356,18,45,.400,.489,12,16,.750,13,84,97,27,8,19,27,42,144
42,Davis Bertans\bertada01,PF,25,SAS,24,0,218,32,76,.421,22,60,.367,10,16,.625,.566,8,10,.800,4,29,33,12,5,8,9,23,94
43,Patrick Beverley\beverpa01,SG,29,LAC,11,11,334,48,119,.403,24,60,.400,24,59,.407,.504,14,17,.824,16,29,45,32,19,5,25,34,134
44,Khem Birch\birchkh01,C,25,ORL,3,0,10,2,5,.400,0,0,,2,5,.400,.400,0,0,,2,0,2,1,0,0,0,3,4
45,Jabari Bird\birdja01,SG,23,BOS,3,0,21,1,4,.250,0,2,.000,1,2,.500,.250,3,5,.600,0,2,2,1,1,0,0,1,5
46,Bismack Biyombo\biyombi01,C,25,ORL,28,0,428,43,90,.478,0,1,.000,43,89,.483,.478,32,53,.604,38,87,125,9,5,31,30,55,118
47,Nemanja Bjelica\bjeline01,PF,29,MIN,18,0,275,48,83,.578,21,41,.512,27,42,.643,.705,11,12,.917,8,43,51,13,10,4,13,30,128
48,Tarik Black\blackta01,C,26,HOU,18,0,159,23,42,.548,0,6,.000,23,36,.639,.548,11,18,.611,17,34,51,6,6,9,11,36,57
49,Antonio Blakeney\blakean01,SG,21,CHI,11,0,163,28,77,.364,8,28,.286,20,49,.408,.416,14,19,.737,3,17,20,7,2,0,8,8,78
50,Eric Bledsoe\bledser01,PG,28,TOT,18,18,554,109,248,.440,26,83,.313,83,165,.503,.492,73,97,.753,15,52,67,72,35,13,49,39,317
50,Eric Bledsoe\bledser01,PG,28,PHO,3,3,83,16,40,.400,4,13,.308,12,27,.444,.450,11,14,.786,3,4,7,9,4,2,10,6,47
50,Eric Bledsoe\bledser01,PG,28,MIL,15,15,471,93,208,.447,22,70,.314,71,138,.514,.500,62,83,.747,12,48,60,63,31,11,39,33,270
51,Vander Blue\blueva01,SG,25,LAL,4,0,28,1,3,.333,0,0,,1,3,.333,.333,0,0,,0,1,1,1,0,0,2,2,2
52,Bogdan Bogdanovic\bogdabo01,SG,25,SAC,24,11,583,89,203,.438,27,83,.325,62,120,.517,.505,29,35,.829,8,46,54,53,28,8,38,43,234
53,Bojan Bogdanovic\bogdabo02,SF,28,IND,27,27,854,144,294,.490,58,137,.423,86,157,.548,.588,48,56,.857,7,76,83,35,16,1,29,46,394
54,Andrew Bogut\bogutan01,C,33,LAL,16,0,123,9,15,.600,0,0,,9,15,.600,.600,0,0,,12,34,46,10,4,10,11,20,18
55,Joel Bolomboy\bolomjo01,PF,24,MIL,5,0,31,1,4,.250,0,1,.000,1,3,.333,.250,3,6,.500,5,3,8,0,2,0,2,2,5
56,Devin Booker\bookede01,SG,21,PHO,25,25,851,213,470,.453,62,162,.383,151,308,.490,.519,120,138,.870,14,99,113,102,23,8,79,75,608
57,Trevor Booker\booketr01,PF,30,TOT,21,5,459,92,173,.532,3,14,.214,89,159,.560,.540,34,54,.630,49,92,141,45,11,8,34,47,221
57,Trevor Booker\booketr01,PF,30,BRK,18,5,395,77,150,.513,3,13,.231,74,137,.540,.523,24,43,.558,38,81,119,38,8,5,30,43,181
57,Trevor Booker\booketr01,PF,30,PHI,3,0,64,15,23,.652,0,1,.000,15,22,.682,.652,10,11,.909,11,11,22,7,3,3,4,4,40
58,Avery Bradley\bradlav01,SG,27,DET,27,27,850,157,371,.423,51,126,.405,106,245,.433,.492,56,69,.812,16,51,67,52,34,5,66,58,421
59,Tony Bradley\bradlto01,C,20,UTA,7,0,21,1,9,.111,0,1,.000,1,8,.125,.111,2,2,1.000,3,5,8,1,0,0,0,1,4
60,Corey Brewer\breweco01,SF,31,LAL,26,1,298,25,58,.431,3,16,.188,22,42,.524,.457,12,18,.667,5,27,32,18,20,4,14,34,65
61,Malcolm Brogdon\brogdma01,PG,25,MIL,24,10,725,122,259,.471,35,88,.398,87,171,.509,.539,33,39,.846,5,61,66,89,23,4,34,57,312
62,Aaron Brooks\brookaa01,PG,33,MIN,11,1,53,10,21,.476,5,10,.500,5,11,.455,.595,1,2,.500,2,4,6,7,1,0,2,7,26
63,Dillon Brooks\brookdi01,SF,22,MEM,27,19,763,81,175,.463,20,60,.333,61,115,.530,.520,24,32,.750,17,74,91,34,23,11,39,94,206
64,Bobby Brown\brownbo02,PG,33,HOU,16,0,102,15,49,.306,9,33,.273,6,16,.375,.398,1,2,.500,0,7,7,10,3,0,8,5,40
65,Jaylen Brown\brownja02,SF,21,BOS,27,27,844,145,313,.463,47,119,.395,98,194,.505,.538,57,96,.594,29,129,158,34,28,7,45,74,394
66,Lorenzo Brown\brownlo01,PG,27,TOR,6,0,49,1,6,.167,0,3,.000,1,3,.333,.167,0,0,,0,7,7,5,4,0,0,3,2
67,Sterling Brown\brownst02,SG,22,MIL,5,0,29,4,12,.333,1,4,.250,3,8,.375,.375,0,0,,2,3,5,2,2,0,1,4,9
68,Nicolas Brussino\brussni01,SF,24,ATL,4,0,10,0,2,.000,0,2,.000,0,0,,.000,0,0,,0,3,3,0,0,0,0,0,0
69,Reggie Bullock\bullore01,SF,26,DET,13,4,195,14,38,.368,3,20,.150,11,18,.611,.408,2,5,.400,5,9,14,12,11,2,3,6,33
70,Alec Burks\burksal01,SG,26,UTA,26,0,514,95,212,.448,29,71,.408,66,141,.468,.517,53,61,.869,8,72,80,33,24,7,25,35,272
71,Jimmy Butler\butleji01,SG,28,MIN,26,26,972,184,403,.457,32,89,.360,152,314,.484,.496,114,135,.844,33,111,144,122,47,7,50,38,514
72,Bruno Caboclo\cabocbr01,SF,22,TOR,2,0,7,0,2,.000,0,2,.000,0,0,,.000,0,0,,0,1,1,1,1,0,0,1,0
73,Jose Calderon\caldejo01,PG,36,CLE,19,13,311,24,51,.471,14,29,.483,10,22,.455,.608,7,8,.875,3,20,23,32,11,0,14,28,69
74,Kentavious Caldwell-Pope\caldwke01,SG,24,LAL,24,24,829,120,288,.417,53,147,.361,67,141,.475,.509,47,65,.723,21,97,118,55,42,7,40,45,340
75,Isaiah Canaan\canaais01,SG,26,HOU,1,0,4,0,1,.000,0,0,,0,1,.000,.000,0,0,,0,1,1,0,0,0,0,0,0
76,Clint Capela\capelca01,C,23,HOU,25,25,629,147,217,.677,0,1,.000,147,216,.681,.677,48,79,.608,80,196,276,30,19,45,39,71,342
77,DeMarre Carroll\carrode01,SF,31,BRK,24,24,708,103,252,.409,44,123,.358,59,129,.457,.496,69,95,.726,39,133,172,40,22,10,35,55,319
78,Vince Carter\cartevi01,SF,41,SAC,17,0,223,18,56,.321,9,31,.290,9,25,.360,.402,3,6,.500,3,20,23,12,7,8,6,21,48
79,Michael Carter-Williams\cartemi01,PG,26,CHO,15,2,259,20,74,.270,5,15,.333,15,59,.254,.304,29,36,.806,13,31,44,37,15,4,22,34,74
80,Alex Caruso\carusal01,PG,23,LAL,2,0,19,1,2,.500,0,0,,1,2,.500,.500,0,0,,0,2,2,4,0,0,2,0,2
81,Omri Casspi\casspom01,SF,29,GSW,24,5,353,55,94,.585,8,13,.615,47,81,.580,.628,25,34,.735,10,87,97,25,7,12,15,36,143
82,Willie Cauley-Stein\caulewi01,C,24,SAC,24,16,595,102,206,.495,1,6,.167,101,200,.505,.498,42,62,.677,41,100,141,52,18,24,35,52,247
83,Tyler Cavanaugh\cavanty01,PF,23,ATL,18,1,254,35,72,.486,16,42,.381,19,30,.633,.597,9,12,.750,20,39,59,21,5,2,8,32,95
84,Mario Chalmers\chalmma01,PG,31,MEM,26,7,598,65,183,.355,16,73,.219,49,110,.445,.399,47,59,.797,4,69,73,90,32,4,43,74,193
85,Tyson Chandler\chandty01,C,35,PHO,21,21,548,63,96,.656,0,0,,63,96,.656,.656,30,47,.638,62,141,203,21,9,15,24,56,156
86,Wilson Chandler\chandwi01,SF,30,DEN,23,23,687,79,188,.420,24,76,.316,55,112,.491,.484,35,41,.854,31,75,106,55,10,8,33,44,217
87,Marquese Chriss\chrisma01,PF,20,PHO,29,23,587,68,166,.410,20,64,.313,48,102,.471,.470,32,44,.727,26,110,136,35,17,31,29,82,188
88,Ian Clark\clarkia01,SG,26,NOP,24,1,361,42,113,.372,19,59,.322,23,54,.426,.456,9,13,.692,2,31,33,32,9,2,16,28,112
89,Jordan Clarkson\clarkjo01,SG,25,LAL,26,0,586,152,314,.484,34,91,.374,118,223,.529,.538,53,68,.779,23,55,78,77,17,0,48,37,391
90,Gian Clavell\clavegi01,SG,24,DAL,7,0,64,6,18,.333,6,15,.400,0,3,.000,.500,2,2,1.000,1,6,7,3,2,0,2,8,20
91,Antonius Cleveland\clevean01,SG,23,DAL,10,0,58,4,12,.333,0,1,.000,4,11,.364,.333,2,4,.500,2,7,9,2,5,4,2,8,10
92,John Collins\collijo01,PF,20,ATL,21,4,484,103,174,.592,0,1,.000,103,173,.595,.592,36,47,.766,66,83,149,17,14,18,31,77,242
93,Zach Collins\colliza01,C,20,POR,10,0,81,7,23,.304,2,7,.286,5,16,.313,.348,1,2,.500,7,8,15,5,3,3,9,18,17
94,Darren Collison\collida01,PG,30,IND,26,26,803,113,246,.459,31,82,.378,82,164,.500,.522,55,63,.873,17,65,82,164,32,5,39,55,312
95,Nick Collison\collini01,PF,37,OKC,5,0,24,3,4,.750,0,0,,3,4,.750,.750,2,2,1.000,3,5,8,3,0,0,2,3,8
96,Mike Conley\conlemi01,PG,30,MEM,12,12,373,64,168,.381,24,77,.312,40,91,.440,.452,53,66,.803,0,27,27,49,12,3,18,24,205
97,Pat Connaughton\connapa01,SG,25,POR,26,5,523,60,135,.444,31,78,.397,29,57,.509,.559,13,14,.929,7,51,58,30,4,7,16,34,164
98,Quinn Cook\cookqu01,PG,24,GSW,6,1,67,10,18,.556,3,9,.333,7,9,.778,.639,1,1,1.000,1,6,7,10,0,0,2,3,24
99,Charles Cooke\cookech01,SG,23,NOP,3,0,5,1,4,.250,0,2,.000,1,2,.500,.250,0,0,,0,0,0,1,1,0,0,0,2
100,Jack Cooley\cooleja01,PF,26,SAC,1,0,2,0,1,.000,0,0,,0,1,.000,.000,2,2,1.000,0,1,1,1,0,0,0,0,2
101,Matt Costello\costema01,C,24,SAS,1,0,11,1,1,1.000,0,0,,1,1,1.000,1.000,0,0,,0,5,5,0,0,2,0,3,2
102,DeMarcus Cousins\couside01,C,27,NOP,28,28,994,252,540,.467,63,182,.346,189,358,.528,.525,165,225,.733,57,293,350,142,44,43,139,101,732
103,Robert Covington\covinro01,PF,27,PHI,25,25,804,131,292,.449,82,192,.427,49,100,.490,.589,38,47,.809,26,129,155,47,41,20,46,80,382
104,Allen Crabbe\crabbal01,SG,25,BRK,23,16,635,95,239,.397,58,153,.379,37,86,.430,.519,35,42,.833,11,82,93,34,14,6,27,41,283
105,Torrey Craig\craigto01,SF,27,DEN,1,0,6,0,1,.000,0,1,.000,0,0,,.000,0,0,,0,1,1,0,0,0,0,0,0
106,Jamal Crawford\crawfja01,SG,37,MIN,28,0,495,89,222,.401,34,98,.347,55,124,.444,.477,45,48,.938,6,26,32,58,14,2,33,31,257
107,Jordan Crawford\crawfjo02,SG,29,NOP,2,0,37,7,14,.500,4,5,.800,3,9,.333,.643,0,0,,2,1,3,9,0,1,4,6,18
108,Jae Crowder\crowdja01,SF,27,CLE,28,25,723,78,202,.386,35,108,.324,43,94,.457,.473,51,57,.895,22,65,87,29,19,5,27,61,242
109,Dante Cunningham\cunnida01,SF,30,NOP,27,19,622,57,133,.429,24,73,.329,33,60,.550,.519,15,26,.577,28,82,110,18,16,8,8,47,153
110,Stephen Curry\curryst01,PG,29,GSW,23,23,750,192,406,.473,83,218,.381,109,188,.580,.575,139,149,.933,15,102,117,151,40,4,67,57,606
111,Troy Daniels\danietr01,SG,26,PHO,29,0,467,67,158,.424,53,128,.414,14,30,.467,.592,7,8,.875,3,29,32,15,7,0,17,39,194
112,Anthony Davis\davisan02,PF,24,NOP,23,23,803,209,368,.568,15,41,.366,194,327,.593,.588,144,183,.787,54,190,244,61,26,41,51,44,577
113,Deyonta Davis\davisde01,C,21,MEM,14,0,165,26,41,.634,0,0,,26,41,.634,.634,7,11,.636,11,35,46,5,4,10,5,24,59
114,Ed Davis\davised01,PF,28,POR,26,0,438,46,92,.500,0,0,,46,92,.500,.500,26,40,.650,66,114,180,9,12,18,23,53,118
115,Dewayne Dedmon\dedmode01,C,28,ATL,20,20,487,92,153,.601,14,29,.483,78,124,.629,.647,23,32,.719,39,116,155,28,8,17,35,60,221
116,Sam Dekker\dekkesa01,SF,23,LAC,21,0,235,30,83,.361,5,36,.139,25,47,.532,.392,10,15,.667,12,32,44,8,9,5,11,21,75
117,Malcolm Delaney\delanma01,PG,28,ATL,20,2,365,34,91,.374,13,36,.361,21,55,.382,.445,19,27,.704,5,29,34,38,14,2,22,25,100
118,Matthew Dellavedova\dellama01,PG,27,MIL,13,1,260,25,66,.379,11,29,.379,14,37,.378,.462,10,11,.909,7,21,28,41,3,0,21,24,71
119,Luol Deng\denglu01,SF,32,LAL,1,1,13,1,2,.500,0,0,,1,2,.500,.500,0,0,,0,0,0,1,1,0,1,0,2
120,DeMar DeRozan\derozde01,SG,28,TOR,25,25,861,204,428,.477,16,61,.262,188,367,.512,.495,156,193,.808,18,95,113,130,32,4,64,45,580
121,Cheick Diallo\diallch01,PF,21,NOP,15,0,109,18,32,.563,0,0,,18,32,.563,.563,3,6,.500,8,25,33,3,0,1,7,20,39
122,Gorgui Dieng\dienggo01,C,28,MIN,25,0,435,65,127,.512,5,23,.217,60,104,.577,.531,31,41,.756,40,78,118,32,17,4,27,51,166
123,Spencer Dinwiddie\dinwisp01,PG,24,BRK,25,15,663,102,261,.391,49,136,.360,53,125,.424,.485,54,72,.750,18,65,83,165,19,10,33,66,307
124,Tyler Dorsey\dorsety01,SG,21,ATL,9,0,53,6,17,.353,4,12,.333,2,5,.400,.471,3,4,.750,1,7,8,3,0,0,4,1,19
125,Damyean Dotson\dotsoda01,SG,23,NYK,17,2,159,21,46,.457,6,20,.300,15,26,.577,.522,2,3,.667,3,21,24,7,2,1,3,11,50
126,Goran Dragic\dragigo01,PG,31,MIA,26,26,823,166,363,.457,44,111,.396,122,252,.484,.518,75,95,.789,17,89,106,115,23,2,60,54,451
127,Andre Drummond\drumman01,C,24,DET,27,27,895,143,268,.534,0,2,.000,143,266,.538,.534,85,139,.612,133,275,408,103,41,31,85,92,371
128,Jared Dudley\dudleja01,PF,32,PHO,12,0,183,16,37,.432,10,24,.417,6,13,.462,.568,9,11,.818,5,26,31,26,7,2,7,25,51
129,Kris Dunn\dunnkr01,PG,23,CHI,22,13,617,118,272,.434,20,52,.385,98,220,.445,.471,24,38,.632,17,90,107,110,42,7,66,72,280
130,Kevin Durant\duranke01,SF,29,GSW,23,23,793,219,422,.519,55,137,.401,164,285,.575,.584,98,112,.875,14,144,158,121,17,49,81,52,591
131,Henry Ellenson\ellenhe01,PF,21,DET,10,0,92,18,45,.400,8,20,.400,10,25,.400,.489,1,1,1.000,2,23,25,6,3,0,8,8,45
132,Wayne Ellington\ellinwa01,SG,30,MIA,26,0,528,72,173,.416,63,153,.412,9,20,.450,.598,15,16,.938,5,45,50,25,16,1,10,23,222
133,Joel Embiid\embiijo01,C,23,PHI,22,22,674,181,372,.487,16,58,.276,165,314,.525,.508,143,179,.799,54,191,245,75,15,42,85,80,521
134,James Ennis\ennisja01,SF,27,MEM,26,14,646,64,129,.496,17,52,.327,47,77,.610,.562,36,41,.878,30,62,92,28,17,5,22,50,181
135,Tyler Ennis\ennisty01,PG,23,LAL,12,0,66,8,22,.364,0,5,.000,8,17,.471,.364,4,4,1.000,1,8,9,9,4,1,4,7,20
136,Jawun Evans\evansja01,PG,21,LAC,18,0,233,29,79,.367,5,20,.250,24,59,.407,.399,18,23,.783,1,23,24,24,9,3,16,29,81
137,Tyreke Evans\evansty01,SG,28,MEM,27,8,805,183,386,.474,52,129,.403,131,257,.510,.541,73,94,.777,24,110,134,108,25,12,54,50,491
138,Kenneth Faried\farieke01,PF,28,DEN,23,7,377,66,113,.584,0,1,.000,66,112,.589,.584,31,43,.721,49,71,120,12,8,10,18,39,163
139,Derrick Favors\favorde01,PF,26,UTA,27,27,749,141,254,.555,5,19,.263,136,235,.579,.565,55,75,.733,62,115,177,46,21,26,40,62,342
140,Kay Felder\feldeka01,PG,22,CHI,14,0,134,20,66,.303,4,18,.222,16,48,.333,.333,11,12,.917,1,13,14,20,3,1,15,11,55
141,Cristiano Felicio\feliccr01,C,25,CHI,21,0,310,36,58,.621,0,0,,36,58,.621,.621,13,22,.591,24,37,61,13,4,4,15,42,85
142,Raymond Felton\feltora01,PG,33,OKC,26,0,439,69,166,.416,18,55,.327,51,111,.459,.470,11,16,.688,6,37,43,62,17,2,18,29,167
143,Terrance Ferguson\fergute01,SG,19,OKC,16,0,116,9,24,.375,1,12,.083,8,12,.667,.396,1,2,.500,3,3,6,1,3,1,3,15,20
144,Yogi Ferrell\ferreyo01,SG,24,DAL,28,11,793,93,219,.425,38,101,.376,55,118,.466,.511,41,51,.804,8,75,83,61,21,3,36,60,265
145,Dorian Finney-Smith\finnedo01,PF,24,DAL,8,1,94,10,22,.455,5,14,.357,5,8,.625,.568,1,2,.500,5,5,10,5,0,1,7,13,26
146,Bryn Forbes\forbebr01,SG,24,SAS,28,2,507,72,166,.434,35,84,.417,37,82,.451,.539,8,19,.421,7,31,38,25,8,2,13,34,187
147,Evan Fournier\fournev01,SF,25,ORL,26,26,845,174,364,.478,59,142,.415,115,222,.518,.559,70,81,.864,14,70,84,79,28,7,50,62,477
148,De'Aaron Fox\foxde01,PG,20,SAC,27,14,710,110,271,.406,11,37,.297,99,234,.423,.426,38,56,.679,13,67,80,105,25,7,62,62,269
149,Tim Frazier\fraziti01,PG,27,WAS,27,11,487,41,97,.423,11,32,.344,30,65,.462,.479,14,16,.875,9,56,65,101,25,3,38,52,107
150,Channing Frye\fryech01,C,34,CLE,26,0,337,47,92,.511,15,47,.319,32,45,.711,.592,7,7,1.000,5,59,64,18,8,6,10,40,116
151,Markelle Fultz\fultzma01,SG,19,PHI,4,0,76,9,27,.333,0,0,,9,27,.333,.333,6,12,.500,3,6,9,7,2,1,6,6,24
152,Danilo Gallinari\gallida01,SF,29,LAC,11,11,349,48,139,.345,16,62,.258,32,77,.416,.403,35,36,.972,2,46,48,29,8,2,16,16,147
153,Langston Galloway\gallola01,SG,26,DET,25,0,342,53,130,.408,36,90,.400,17,40,.425,.546,13,15,.867,4,40,44,17,9,3,7,16,155
154,Marc Gasol\gasolma01,C,33,MEM,27,27,944,178,422,.422,38,115,.330,140,307,.456,.467,120,147,.816,35,196,231,113,15,39,81,64,514
155,Pau Gasol\gasolpa01,C,37,SAS,27,27,681,109,226,.482,23,56,.411,86,170,.506,.533,53,65,.815,38,174,212,81,10,33,37,42,294
156,Rudy Gay\gayru01,SF,31,SAS,26,4,614,126,255,.494,18,55,.327,108,200,.540,.529,62,77,.805,39,106,145,45,25,17,45,51,332
157,Paul George\georgpa01,SF,27,OKC,24,24,888,172,411,.418,72,176,.409,100,235,.426,.506,79,96,.823,19,119,138,77,58,14,68,70,495
158,Marcus Georges-Hunt\georgma01,SG,23,MIN,9,0,15,2,4,.500,0,1,.000,2,3,.667,.500,0,0,,1,0,1,1,1,0,1,2,4
159,Taj Gibson\gibsota01,PF,32,MIN,28,28,937,123,228,.539,5,19,.263,118,209,.565,.550,58,72,.806,79,159,238,43,25,18,39,76,309
160,Manu Ginobili\ginobma01,SG,40,SAS,23,0,490,65,163,.399,21,72,.292,44,91,.484,.463,40,47,.851,7,44,51,56,14,5,41,48,191
161,Rudy Gobert\goberru01,C,25,UTA,16,16,510,73,119,.613,0,0,,73,119,.613,.613,56,82,.683,44,116,160,20,10,36,35,41,202
162,Aaron Gordon\gordoaa01,PF,22,ORL,25,25,842,163,331,.492,55,137,.401,108,194,.557,.576,81,107,.757,37,165,202,55,25,22,38,45,462
163,Eric Gordon\gordoer01,SG,29,HOU,23,13,728,136,337,.404,70,218,.321,66,119,.555,.507,94,111,.847,5,43,48,56,15,9,54,41,436
164,Marcin Gortat\gortama01,C,33,WAS,27,27,768,103,195,.528,0,0,,103,195,.528,.528,39,58,.672,60,172,232,58,18,17,40,57,245
165,Treveon Graham\grahatr01,SG,24,CHO,16,0,288,30,68,.441,12,29,.414,18,39,.462,.529,12,15,.800,13,22,35,23,10,0,9,32,84
166,Jerami Grant\grantje01,PF,23,OKC,25,1,545,70,143,.490,10,38,.263,60,105,.571,.524,45,63,.714,31,64,95,21,17,21,22,50,195
167,Jerian Grant\grantje02,PG,25,CHI,26,14,622,78,183,.426,20,63,.317,58,120,.483,.481,49,65,.754,15,55,70,134,23,2,36,50,225
168,Danny Green\greenda02,SG,30,SAS,26,26,734,92,227,.405,46,124,.371,46,103,.447,.507,11,15,.733,13,88,101,51,27,31,38,33,241
169,Draymond Green\greendr01,PF,27,GSW,25,25,805,87,193,.451,30,91,.330,57,102,.559,.528,48,63,.762,26,155,181,183,39,36,68,70,252
170,JaMychal Green\greenja01,PF,27,MEM,15,15,414,58,117,.496,13,33,.394,45,84,.536,.551,18,26,.692,24,59,83,19,7,2,22,39,147
171,Jeff Green\greenje02,PF,31,CLE,28,0,610,110,216,.509,15,50,.300,95,166,.572,.544,64,75,.853,24,73,97,42,20,7,28,58,299
172,Blake Griffin\griffbl01,PF,28,LAC,19,19,680,150,353,.425,41,116,.353,109,237,.460,.483,107,137,.781,25,125,150,96,18,6,57,48,448
173,Daniel Hamilton\hamilda02,SG,22,OKC,1,0,4,0,1,.000,0,0,,0,1,.000,.000,0,0,,0,0,0,0,0,0,0,0,0
174,Tim Hardaway\hardati02,SG,25,NYK,21,21,716,133,317,.420,48,152,.316,85,165,.515,.495,60,75,.800,17,71,88,70,24,5,36,46,374
175,James Harden\hardeja01,SG,28,HOU,25,25,897,245,529,.463,110,271,.406,135,258,.523,.567,201,233,.863,15,113,128,237,47,10,109,65,801
176,Maurice Harkless\harklma01,SF,24,POR,24,19,551,48,116,.414,10,39,.256,38,77,.494,.457,18,24,.750,18,58,76,15,18,21,19,41,124
177,Montrezl Harrell\harremo01,C,24,LAC,19,2,212,47,71,.662,0,0,,47,71,.662,.662,21,28,.750,22,38,60,12,6,9,8,23,115
178,Devin Harris\harride01,PG,34,DAL,22,1,415,59,149,.396,20,60,.333,39,89,.438,.463,50,62,.806,8,37,45,44,20,4,22,61,188
179,Gary Harris\harriga01,SG,23,DEN,25,25,836,142,306,.464,57,146,.390,85,160,.531,.557,36,45,.800,19,57,76,74,48,9,45,53,377
180,Joe Harris\harrijo01,SG,26,BRK,24,3,574,86,190,.453,51,131,.389,35,59,.593,.587,19,27,.704,11,58,69,31,14,6,22,53,242
181,Tobias Harris\harrito02,PF,25,DET,27,27,898,183,395,.463,74,167,.443,109,228,.478,.557,52,57,.912,27,122,149,41,18,5,24,50,492
182,Andrew Harrison\harrian01,PG,23,MEM,21,11,380,42,107,.393,13,43,.302,29,64,.453,.453,29,34,.853,8,30,38,44,15,6,23,32,126
183,Josh Hart\hartjo01,SG,22,LAL,21,0,292,24,54,.444,9,25,.360,15,29,.517,.528,10,14,.714,7,39,46,9,12,4,9,18,67
184,Udonis Haslem\hasleud01,C,37,MIA,3,0,10,1,1,1.000,0,0,,1,1,1.000,1.000,0,0,,0,1,1,2,0,0,0,1,2
185,Gordon Hayward\haywago01,SF,27,BOS,1,1,5,1,2,.500,0,1,.000,1,1,1.000,.500,0,0,,0,1,1,0,0,0,0,1,2
186,John Henson\hensojo01,C,27,MIL,24,17,561,75,133,.564,0,2,.000,75,131,.573,.564,23,49,.469,44,116,160,33,11,38,32,70,173
187,Juan Hernangomez\hernaju01,PF,22,DEN,14,3,190,19,47,.404,11,32,.344,8,15,.533,.521,5,7,.714,12,24,36,8,4,2,6,17,54
188,Willy Hernangomez\hernawi01,C,23,NYK,14,0,153,35,61,.574,1,4,.250,34,57,.596,.582,4,15,.267,19,32,51,13,5,6,19,25,75
189,Mario Hezonja\hezonma01,SF,22,ORL,21,1,228,26,64,.406,9,30,.300,17,34,.500,.477,3,4,.750,9,32,41,14,8,2,15,23,64
190,Buddy Hield\hieldbu01,SG,24,SAC,25,7,578,121,266,.455,50,106,.472,71,160,.444,.549,22,25,.880,15,79,94,40,28,4,40,45,314
191,Nene Hilario\hilarne01,C,35,HOU,18,0,253,53,81,.654,0,2,.000,53,79,.671,.654,33,44,.750,14,40,54,18,10,6,20,47,139
192,George Hill\hillge01,PG,31,SAC,24,24,614,82,179,.458,27,61,.443,55,118,.466,.534,33,43,.767,11,63,74,59,23,6,31,36,224
193,Darrun Hilliard\hillida01,SG,24,SAS,4,0,39,1,7,.143,0,2,.000,1,5,.200,.143,1,2,.500,0,3,3,4,2,0,3,4,3
194,Jrue Holiday\holidjr01,PG,27,NOP,28,28,1030,201,413,.487,43,137,.314,158,276,.572,.539,58,69,.841,16,104,120,154,35,13,76,67,503
195,Justin Holiday\holidju01,SG,28,CHI,25,25,848,119,326,.365,63,182,.346,56,144,.389,.462,46,58,.793,14,97,111,51,32,17,31,51,347
196,John Holland\hollajo02,SF,29,CLE,4,0,17,1,4,.250,1,2,.500,0,2,.000,.375,0,0,,0,2,2,0,0,0,1,0,3
197,Rondae Hollis-Jefferson\holliro01,SF,23,BRK,23,22,635,116,237,.489,6,20,.300,110,217,.507,.502,95,117,.812,32,104,136,43,19,18,32,42,333
198,Richaun Holmes\holmeri01,C,24,PHI,13,2,208,39,72,.542,3,16,.188,36,56,.643,.563,14,19,.737,17,44,61,11,4,6,6,32,95
199,Rodney Hood\hoodro01,SG,25,UTA,18,9,509,111,265,.419,51,127,.402,60,138,.435,.515,46,50,.920,5,42,47,32,13,4,35,35,319
200,Al Horford\horfoal01,C,31,BOS,27,27,882,149,281,.530,38,93,.409,111,188,.590,.598,42,52,.808,35,180,215,143,15,28,56,46,378
201,Danuel House\houseda01,SG,24,PHO,1,0,11,1,3,.333,0,2,.000,1,1,1.000,.333,0,0,,0,1,1,0,0,0,1,0,2
202,Dwight Howard\howardw01,C,32,CHO,26,26,775,158,281,.562,0,1,.000,158,280,.564,.562,100,200,.500,90,228,318,31,13,35,94,90,416
203,Josh Huestis\huestjo01,PF,26,OKC,20,0,221,17,51,.333,12,37,.324,5,14,.357,.451,2,6,.333,8,24,32,7,6,9,13,29,48
204,Vince Hunter\huntevi01,PF,23,MEM,2,0,5,2,2,1.000,0,0,,2,2,1.000,1.000,0,0,,1,1,2,0,0,0,1,0,4
205,Serge Ibaka\ibakase01,PF,28,TOR,23,23,632,120,240,.500,40,105,.381,80,135,.593,.583,23,35,.657,16,110,126,14,8,33,25,69,303
206,Andre Iguodala\iguodan01,SF,34,GSW,24,1,636,56,121,.463,13,45,.289,43,76,.566,.517,24,38,.632,24,73,97,71,17,15,25,30,149
207,Ersan Ilyasova\ilyaser01,PF,30,ATL,16,10,358,51,121,.421,22,58,.379,29,63,.460,.512,14,20,.700,23,51,74,18,20,6,8,37,138
208,Joe Ingles\inglejo01,SF,30,UTA,27,27,806,101,226,.447,71,155,.458,30,71,.423,.604,15,18,.833,7,97,104,108,32,5,47,57,288
209,Brandon Ingram\ingrabr01,SF,20,LAL,26,26,889,153,345,.443,13,42,.310,140,303,.462,.462,92,137,.672,28,117,145,78,23,20,68,84,411
210,Kyrie Irving\irvinky01,PG,25,BOS,27,27,863,235,478,.492,62,156,.397,173,322,.537,.556,108,123,.878,14,68,82,129,38,8,61,57,640
211,Jonathan Isaac\isaacjo01,PF,20,ORL,12,2,239,28,61,.459,5,17,.294,23,44,.523,.500,12,14,.857,11,42,53,10,8,15,12,25,73
212,Wesley Iwundu\iwundwe01,SF,23,ORL,10,0,83,8,26,.308,1,4,.250,7,22,.318,.327,1,3,.333,2,11,13,6,2,0,3,7,18
213,Jarrett Jack\jackja01,PG,34,NYK,25,24,653,67,157,.427,8,29,.276,59,128,.461,.452,15,21,.714,7,78,85,153,11,1,44,36,157
214,Demetrius Jackson\jacksde01,PG,23,HOU,12,0,63,4,14,.286,0,6,.000,4,8,.500,.286,0,0,,4,7,11,5,4,1,10,6,8
215,Josh Jackson\jacksjo02,SF,20,PHO,29,7,643,100,260,.385,17,71,.239,83,189,.439,.417,49,89,.551,26,78,104,33,33,6,58,82,266
216,Justin Jackson\jacksju01,SF,22,SAC,18,5,343,44,113,.389,16,49,.327,28,64,.438,.460,6,10,.600,9,24,33,10,3,3,13,18,110
217,Reggie Jackson\jacksre01,PG,27,DET,27,27,745,156,338,.462,38,102,.373,118,236,.500,.518,73,87,.839,22,55,77,140,20,2,65,56,423
218,LeBron James\jamesle01,PF,33,CLE,28,28,1042,306,525,.583,57,135,.422,249,390,.638,.637,120,157,.764,35,195,230,252,40,31,114,49,789
219,Mike James\jamesmi02,PG,27,PHO,29,10,629,115,293,.392,25,92,.272,90,201,.448,.435,63,82,.768,12,70,82,110,26,7,46,44,318
220,Al Jefferson\jeffeal01,C,33,IND,10,0,139,31,57,.544,0,1,.000,31,56,.554,.544,10,12,.833,11,36,47,11,5,7,8,18,72
221,Richard Jefferson\jefferi01,SF,37,DEN,8,0,56,4,13,.308,1,5,.200,3,8,.375,.346,2,5,.400,0,3,3,7,0,0,0,3,11
222,Jonas Jerebko\jerebjo01,PF,30,UTA,22,10,371,52,104,.500,23,50,.460,29,54,.537,.611,8,10,.800,19,64,83,18,8,3,9,43,135
223,Amir Johnson\johnsam01,C,30,PHI,25,4,390,45,91,.495,2,13,.154,43,78,.551,.505,17,31,.548,49,82,131,34,17,19,24,73,109
224,Brice Johnson\johnsbr02,PF,23,LAC,7,0,28,5,8,.625,0,1,.000,5,7,.714,.625,2,2,1.000,1,8,9,1,4,1,3,7,12
225,Dakari Johnson\johnsda04,C,22,OKC,12,3,77,10,21,.476,0,0,,10,21,.476,.476,7,12,.583,8,5,13,5,3,4,2,16,27
226,James Johnson\johnsja01,PF,30,MIA,25,8,693,105,211,.498,23,65,.354,82,146,.562,.552,48,69,.696,22,105,127,102,26,19,62,71,281
227,Joe Johnson\johnsjo02,SF,36,UTA,7,0,134,18,46,.391,2,17,.118,16,29,.552,.413,6,7,.857,4,15,19,11,4,2,10,7,44
228,Stanley Johnson\johnsst04,SF,21,DET,24,22,680,61,173,.353,24,84,.286,37,89,.416,.422,23,32,.719,9,75,84,32,31,5,23,61,169
229,Tyler Johnson\johnsty01,PG,25,MIA,25,0,686,93,229,.406,42,115,.365,51,114,.447,.498,43,47,.915,10,70,80,49,15,20,31,51,271
230,Wesley Johnson\johnswe01,SF,30,LAC,25,16,640,69,164,.421,24,80,.300,45,84,.536,.494,21,29,.724,12,76,88,26,27,28,26,62,183
231,Nikola Jokic\jokicni01,C,22,DEN,21,21,618,123,241,.510,28,69,.406,95,172,.552,.568,51,59,.864,55,168,223,96,29,13,46,50,325
232,Derrick Jones\jonesde02,SF,20,PHO,6,0,33,2,4,.500,0,2,.000,2,2,1.000,.500,5,6,.833,2,2,4,3,1,4,1,2,9
233,Jalen Jones\jonesja04,SF,24,NOP,4,0,19,1,4,.250,1,1,1.000,0,3,.000,.375,2,2,1.000,0,3,3,0,0,0,0,2,5
234,Tyus Jones\jonesty01,PG,21,MIN,28,3,478,38,88,.432,13,34,.382,25,54,.463,.506,20,25,.800,6,46,52,76,31,2,16,30,109
235,DeAndre Jordan\jordade01,C,29,LAC,25,25,813,113,168,.673,0,0,,113,168,.673,.673,41,69,.594,122,238,360,27,13,28,47,74,267
236,Cory Joseph\josepco01,PG,26,IND,27,1,669,75,185,.405,31,70,.443,44,115,.383,.489,28,31,.903,6,65,71,83,28,6,29,35,209
237,Frank Kaminsky\kaminfr01,PF,24,CHO,23,0,531,89,211,.422,26,76,.342,63,135,.467,.483,37,49,.755,12,80,92,34,9,5,19,30,241
238,Enes Kanter\kanteen01,C,25,NYK,24,24,620,138,229,.603,0,1,.000,138,228,.605,.603,46,50,.920,88,160,248,33,14,10,41,60,322
239,Luke Kennard\kennalu01,SG,21,DET,22,0,359,51,121,.421,21,54,.389,30,67,.448,.508,11,15,.733,3,30,33,24,13,1,21,19,134
240,Michael Kidd-Gilchrist\kiddgmi01,SF,24,CHO,20,20,533,83,166,.500,0,1,.000,83,165,.503,.500,26,38,.684,21,69,90,18,16,16,8,42,192
241,Sean Kilpatrick\kilpase01,SG,28,BRK,16,0,183,25,86,.291,11,42,.262,14,44,.318,.355,18,19,.947,1,34,35,15,2,1,16,8,79
242,Maxi Kleber\klebima01,PF,26,DAL,22,13,386,49,91,.538,11,34,.324,38,57,.667,.599,12,19,.632,24,50,74,9,5,11,8,37,121
243,Furkan Korkmaz\korkmfu01,SG,20,PHI,6,0,32,3,12,.250,1,8,.125,2,4,.500,.292,2,2,1.000,2,4,6,2,1,0,1,4,9
244,Kyle Korver\korveky01,SG,36,CLE,28,0,630,97,205,.473,74,166,.446,23,39,.590,.654,30,35,.857,3,55,58,29,12,11,21,48,298
245,Kosta Koufos\koufoko01,C,28,SAC,27,1,493,56,105,.533,0,0,,56,105,.533,.533,18,39,.462,45,112,157,31,14,15,18,45,130
246,Kyle Kuzma\kuzmaky01,PF,22,LAL,25,11,760,157,320,.491,41,110,.373,116,210,.552,.555,48,63,.762,40,126,166,38,9,6,45,50,403
247,Mindaugas Kuzminskas\kuzmimi01,SF,28,NYK,1,0,2,0,2,.000,0,0,,0,2,.000,.000,0,0,,0,0,0,0,0,0,0,0,0
248,Skal Labissiere\labissk01,PF,21,SAC,25,11,421,75,172,.436,4,9,.444,71,163,.436,.448,34,43,.791,34,69,103,18,11,15,29,52,188
249,Jeremy Lamb\lambje01,SG,25,CHO,25,14,687,134,304,.441,32,93,.344,102,211,.483,.493,69,80,.863,12,111,123,74,20,12,42,49,369
250,Shane Larkin\larkish01,PG,25,BOS,20,0,208,20,67,.299,8,27,.296,12,40,.300,.358,13,16,.813,3,17,20,25,8,0,5,22,61
251,Joffrey Lauvergne\lauvejo01,C,26,SAS,14,0,153,22,49,.449,0,3,.000,22,46,.478,.449,8,14,.571,19,29,48,9,5,0,10,19,52
252,Jake Layman\laymaja01,SF,23,POR,12,0,79,9,28,.321,2,11,.182,7,17,.412,.357,2,2,1.000,2,8,10,2,3,2,1,9,22
253,T.J. Leaf\leaftj01,PF,20,IND,23,0,234,32,71,.451,10,22,.455,22,49,.449,.521,3,7,.429,15,25,40,5,5,2,6,26,77
254,Courtney Lee\leeco01,SG,32,NYK,27,27,870,132,276,.478,41,95,.432,91,181,.503,.553,38,41,.927,13,82,95,75,37,3,33,40,343
255,Alex Len\lenal01,C,24,PHO,24,2,528,74,142,.521,0,0,,74,142,.521,.521,68,90,.756,72,142,214,21,6,23,30,57,216
256,Kawhi Leonard\leonaka01,SF,26,SAS,1,1,16,6,12,.500,1,4,.250,5,8,.625,.542,0,0,,1,5,6,1,1,1,0,0,13
257,Meyers Leonard\leoname01,PF,25,POR,11,2,129,27,45,.600,7,13,.538,20,32,.625,.678,6,8,.750,5,27,32,6,2,0,3,19,67
258,Jon Leuer\leuerjo01,PF,28,DET,8,0,136,15,36,.417,0,3,.000,15,33,.455,.417,13,15,.867,7,25,32,5,1,3,8,16,43
259,Caris LeVert\leverca01,SF,23,BRK,26,8,685,108,254,.425,27,90,.300,81,164,.494,.478,50,73,.685,13,81,94,99,34,11,58,63,293
260,DeAndre Liggins\liggide01,SG,29,MIL,22,0,354,18,54,.333,10,30,.333,8,24,.333,.426,2,5,.400,3,30,33,17,20,8,12,43,48
261,Damian Lillard\lillada01,PG,27,POR,26,26,967,219,516,.424,76,216,.352,143,300,.477,.498,177,191,.927,26,106,132,160,26,12,77,44,691
262,Jeremy Lin\linje01,PG,29,BRK,1,1,25,5,12,.417,1,2,.500,4,10,.400,.458,7,7,1.000,0,0,0,4,0,0,3,3,18
263,Shaun Livingston\livinsh01,PG,32,GSW,25,3,397,54,110,.491,0,2,.000,54,108,.500,.491,15,20,.750,16,31,47,49,10,8,20,37,123
264,Kevon Looney\looneke01,C,21,GSW,21,0,206,24,44,.545,0,0,,24,44,.545,.545,8,18,.444,18,37,55,8,7,16,12,38,56
265,Brook Lopez\lopezbr01,C,29,LAL,26,26,595,128,289,.443,33,107,.308,95,182,.522,.500,55,69,.797,34,83,117,45,11,42,45,77,344
266,Robin Lopez\lopezro01,C,29,CHI,26,26,786,152,288,.528,2,7,.286,150,281,.534,.531,37,49,.755,70,74,144,53,6,21,51,61,343
267,Kevin Love\loveke01,C,29,CLE,27,27,788,165,354,.466,53,138,.384,112,216,.519,.541,133,153,.869,69,213,282,50,17,11,52,60,516
268,Kyle Lowry\lowryky01,PG,31,TOR,25,25,828,132,304,.434,75,192,.391,57,112,.509,.558,71,82,.866,16,143,159,176,23,3,66,54,410
269,Timothe Luwawu-Cabarrot\luwawti01,SF,22,PHI,26,1,425,57,148,.385,25,82,.305,32,66,.485,.470,26,35,.743,12,32,44,25,8,1,23,56,165
270,Tyler Lydon\lydonty01,PF,21,DEN,1,0,2,0,0,,0,0,,0,0,,,0,0,,0,0,0,0,0,0,0,0,0
271,Trey Lyles\lylestr01,PF,22,DEN,22,0,310,55,109,.505,21,44,.477,34,65,.523,.601,24,31,.774,16,58,74,15,6,9,15,18,155
272,Shelvin Mack\macksh01,PG,27,ORL,21,2,365,33,87,.379,9,27,.333,24,60,.400,.431,13,21,.619,6,36,42,95,13,2,21,21,88
273,Josh Magette\magetjo01,PG,28,ATL,8,0,64,4,12,.333,1,4,.250,3,8,.375,.375,4,4,1.000,1,5,6,17,2,0,2,6,13
274,Ian Mahinmi\mahinia01,C,31,WAS,26,0,391,34,71,.479,0,0,,34,71,.479,.479,32,41,.780,49,50,99,16,13,11,30,85,100
275,Thon Maker\makerth01,C,20,MIL,25,8,477,41,105,.390,10,37,.270,31,68,.456,.438,17,25,.680,26,61,87,19,16,19,20,66,109
276,Boban Marjanovic\marjabo01,C,29,DET,8,0,62,18,30,.600,0,0,,18,30,.600,.600,16,22,.727,8,9,17,5,2,1,10,17,52
277,Lauri Markkanen\markkla01,PF,20,CHI,25,25,767,130,324,.401,56,167,.335,74,157,.471,.488,52,62,.839,27,175,202,32,13,15,35,43,368
278,Jarell Martin\martija01,PF,23,MEM,25,12,418,42,109,.385,8,31,.258,34,78,.436,.422,16,20,.800,22,53,75,10,15,18,21,69,108
279,Frank Mason\masonfr01,PG,23,SAC,20,0,376,54,136,.397,13,30,.433,41,106,.387,.445,41,53,.774,8,32,40,64,9,1,31,24,162
280,Mangok Mathiang\mathima01,C,25,CHO,1,0,3,0,2,.000,0,0,,0,2,.000,.000,0,0,,1,1,2,0,0,0,0,0,0
281,Wesley Matthews\matthwe02,SG,31,DAL,28,27,968,123,303,.406,71,173,.410,52,130,.400,.523,31,39,.795,9,77,86,79,29,4,41,63,348
282,Luc Mbah a Moute\mbahalu01,PF,31,HOU,23,3,598,59,129,.457,25,66,.379,34,63,.540,.554,18,27,.667,13,67,80,22,30,12,30,43,161
283,James Michael McAdoo\mcadoja01,PF,25,PHI,1,0,7,1,4,.250,1,4,.250,0,0,,.375,2,2,1.000,0,0,0,0,0,0,1,0,5
284,Patrick McCaw\mccawpa01,SG,22,GSW,24,1,321,34,69,.493,13,32,.406,21,37,.568,.587,7,9,.778,5,16,21,36,15,4,10,23,88
285,C.J. McCollum\mccolcj01,SG,26,POR,25,25,910,198,439,.451,63,143,.441,135,296,.456,.523,66,76,.868,15,91,106,67,24,9,54,64,525
286,T.J. McConnell\mccontj01,PG,25,PHI,22,1,531,64,122,.525,9,16,.563,55,106,.519,.561,11,13,.846,15,64,79,112,25,4,44,46,148
287,Chris McCullough\mcculch01,PF,22,WAS,6,0,45,8,21,.381,1,5,.200,7,16,.438,.405,5,8,.625,3,9,12,1,0,2,0,7,22
288,Doug McDermott\mcderdo01,SF,26,NYK,27,0,651,92,187,.492,30,75,.400,62,112,.554,.572,16,20,.800,20,62,82,31,5,9,19,47,230
289,JaVale McGee\mcgeeja01,C,30,GSW,24,2,193,35,64,.547,0,2,.000,35,62,.565,.547,14,18,.778,17,32,49,13,8,18,9,29,84
290,Alfonzo McKinnie\mckinal01,SF,25,TOR,8,0,25,4,6,.667,1,3,.333,3,3,1.000,.750,2,3,.667,0,5,5,1,0,1,1,6,11
291,Ben McLemore\mclembe01,SG,24,MEM,16,5,304,43,101,.426,14,42,.333,29,59,.492,.495,12,14,.857,6,31,37,15,8,5,18,41,112
292,Jodie Meeks\meeksjo01,SG,30,WAS,27,0,451,59,160,.369,25,80,.313,34,80,.425,.447,51,57,.895,6,29,35,16,16,1,14,27,194
293,Salah Mejri\mejrisa01,C,31,DAL,24,1,267,28,40,.700,0,2,.000,28,38,.737,.700,12,23,.522,29,65,94,11,7,30,11,42,68
294,Jordan Mickey\mickejo01,PF,23,MIA,6,2,45,6,12,.500,0,2,.000,6,10,.600,.500,4,5,.800,4,15,19,0,0,3,3,5,16
295,Khris Middleton\middlkh01,SF,26,MIL,25,25,922,185,388,.477,48,127,.378,137,261,.525,.539,84,95,.884,15,118,133,108,30,2,58,87,502
296,C.J. Miles\milescj01,SF,30,TOR,22,0,407,74,184,.402,52,138,.377,22,46,.478,.543,23,26,.885,5,36,41,16,17,9,13,41,223
297,Darius Miller\milleda01,SF,27,NOP,28,2,568,73,153,.477,53,117,.453,20,36,.556,.650,16,20,.800,5,41,46,31,10,4,15,46,215
298,Patty Mills\millspa02,PG,29,SAS,28,12,712,93,234,.397,51,137,.372,42,97,.433,.506,31,34,.912,10,55,65,98,22,6,41,40,268
299,Paul Millsap\millspa01,PF,32,DEN,16,16,475,90,202,.446,20,58,.345,70,144,.486,.495,45,65,.692,24,75,99,48,17,20,33,39,245
300,Nikola Mirotic\mirotni01,PF,26,CHI,3,1,67,17,31,.548,9,18,.500,8,13,.615,.694,6,11,.545,2,12,14,0,0,2,1,5,49
301,Donovan Mitchell\mitchdo01,SG,21,UTA,27,19,801,169,412,.410,65,174,.374,104,238,.437,.489,64,76,.842,16,65,81,87,39,12,66,83,467
302,Malik Monk\monkma01,SG,19,CHO,23,0,377,54,165,.327,29,91,.319,25,74,.338,.415,12,17,.706,2,30,32,39,7,3,19,24,149
303,Greg Monroe\monrogr01,C,27,TOT,16,8,324,67,117,.573,0,0,,67,117,.573,.573,20,27,.741,31,79,110,32,9,3,25,29,154
303,Greg Monroe\monrogr01,C,27,MIL,5,0,79,16,33,.485,0,0,,16,33,.485,.485,2,4,.500,6,19,25,5,0,0,6,7,34
303,Greg Monroe\monrogr01,C,27,PHO,11,8,245,51,84,.607,0,0,,51,84,.607,.607,18,23,.783,25,60,85,27,9,3,19,22,120
304,E'Twaun Moore\mooreet01,SG,28,NOP,28,26,903,154,287,.537,53,112,.473,101,175,.577,.629,11,18,.611,24,49,73,57,28,4,33,73,372
305,Eric Moreland\moreler01,PF,26,DET,23,0,236,11,22,.500,0,0,,11,22,.500,.500,4,8,.500,28,42,70,18,6,16,13,42,26
306,Marcus Morris\morrima03,SF,28,BOS,16,9,387,68,165,.412,20,61,.328,48,104,.462,.473,38,45,.844,7,81,88,25,10,4,17,28,194
307,Markieff Morris\morrima02,PF,28,WAS,20,20,464,79,176,.449,21,57,.368,58,119,.487,.509,18,22,.818,19,62,81,23,11,13,32,62,197
308,Monte Morris\morrimo01,PG,22,DEN,1,0,3,0,1,.000,0,1,.000,0,0,,.000,0,0,,0,0,0,1,0,0,0,0,0
309,Timofey Mozgov\mozgoti01,C,31,BRK,19,14,260,36,63,.571,3,16,.188,33,47,.702,.595,10,15,.667,25,51,76,3,3,8,23,26,85
310,Emmanuel Mudiay\mudiaem01,PG,21,DEN,27,0,586,92,234,.393,31,76,.408,61,158,.386,.459,54,68,.794,13,61,74,89,15,3,59,35,269
311,Shabazz Muhammad\muhamsh01,SF,25,MIN,22,2,250,35,91,.385,4,19,.211,31,72,.431,.407,13,18,.722,12,26,38,7,5,2,3,19,87
312,Dejounte Murray\murrade01,PG,21,SAS,28,9,503,68,165,.412,3,9,.333,65,156,.417,.421,36,49,.735,34,91,125,65,21,6,43,46,175
313,Jamal Murray\murraja01,PG,20,DEN,27,27,725,142,325,.437,40,125,.320,102,200,.510,.498,66,71,.930,29,44,73,64,20,8,52,52,390
314,Mike Muscala\muscami01,C,26,ATL,9,5,202,21,51,.412,6,19,.316,15,32,.469,.471,11,12,.917,11,29,40,9,7,5,8,23,59
315,Abdel Nader\naderab01,SF,24,BOS,13,0,100,10,28,.357,4,14,.286,6,14,.429,.429,0,1,.000,2,9,11,4,3,3,6,8,24
316,Larry Nance\nancela02,PF,25,LAL,15,15,355,58,100,.580,0,2,.000,58,98,.592,.580,19,26,.731,36,67,103,16,24,8,18,50,135
317,Shabazz Napier\napiesh01,PG,26,POR,20,0,325,49,104,.471,17,35,.486,32,69,.464,.553,30,35,.857,5,32,37,29,21,2,14,19,145
318,Jameer Nelson\nelsoja01,PG,35,NOP,24,0,597,54,126,.429,25,66,.379,29,60,.483,.528,12,15,.800,7,55,62,102,18,3,37,44,145
319,Raul Neto\netora01,PG,25,UTA,17,0,226,33,70,.471,10,22,.455,23,48,.479,.543,8,13,.615,2,21,23,33,6,2,12,14,84
320,Joakim Noah\noahjo01,C,32,NYK,2,0,11,2,3,.667,0,0,,2,3,.667,.667,1,2,.500,2,3,5,3,1,1,1,1,5
321,Nerlens Noel\noelne01,C,23,DAL,18,6,225,28,53,.528,0,0,,28,53,.528,.528,16,19,.842,26,47,73,6,10,10,15,31,72
322,Lucas Nogueira\noguelu01,C,25,TOR,17,2,204,28,47,.596,3,10,.300,25,37,.676,.628,7,9,.778,9,37,46,6,11,20,9,27,66
323,Dirk Nowitzki\nowitdi01,C,39,DAL,28,28,701,117,264,.443,42,101,.416,75,163,.460,.523,34,37,.919,12,144,156,47,16,8,24,50,310
324,Frank Ntilikina\ntilila01,PG,19,NYK,24,0,482,52,146,.356,15,46,.326,37,100,.370,.408,21,29,.724,10,39,49,78,33,3,47,62,140
325,Jusuf Nurkic\nurkiju01,C,23,POR,24,24,673,148,325,.455,0,5,.000,148,320,.463,.455,67,104,.644,44,142,186,49,18,30,73,75,363
326,David Nwaba\nwabada01,SG,25,CHI,14,3,319,43,75,.573,2,7,.286,41,68,.603,.587,28,43,.651,9,65,74,22,10,12,9,25,116
327,Johnny O'Bryant\obryajo01,PF,24,CHO,12,0,108,21,55,.382,3,12,.250,18,43,.419,.409,10,10,1.000,7,20,27,5,4,3,5,10,55
328,Royce O'Neale\onealro01,SF,24,UTA,18,0,197,16,47,.340,7,24,.292,9,23,.391,.415,9,14,.643,3,33,36,20,8,1,7,16,48
329,Kyle O'Quinn\oquinky01,C,27,NYK,27,3,437,68,120,.567,0,4,.000,68,116,.586,.567,30,38,.789,42,118,160,55,11,27,43,73,166
330,Semi Ojeleye\ojelese01,PF,23,BOS,28,0,388,22,70,.314,16,56,.286,6,14,.429,.429,10,16,.625,18,42,60,6,8,0,8,26,70
331,Jahlil Okafor\okafoja01,C,22,PHI,2,0,25,4,9,.444,0,0,,4,9,.444,.444,2,4,.500,4,5,9,1,0,2,3,7,10
332,Victor Oladipo\oladivi01,SG,25,IND,26,26,883,229,472,.485,71,160,.444,158,312,.506,.560,109,141,.773,17,122,139,104,48,28,87,64,638
333,Kelly Olynyk\olynyke01,PF,26,MIA,26,4,537,84,164,.512,30,68,.441,54,96,.563,.604,40,50,.800,24,114,138,52,17,13,54,83,238
334,Cedi Osman\osmande01,SF,22,CLE,20,0,133,14,32,.438,5,16,.313,9,16,.563,.516,2,2,1.000,3,31,34,4,3,1,7,20,35
335,Kelly Oubre\oubreke01,SF,22,WAS,27,6,741,102,249,.410,40,107,.374,62,142,.437,.490,63,78,.808,21,121,142,28,25,12,30,73,307
336,Zaza Pachulia\pachuza01,C,33,GSW,25,25,359,51,91,.560,0,0,,51,91,.560,.560,23,29,.793,28,92,120,39,19,6,32,43,125
337,Marcus Paige\paigema01,PG,24,CHO,1,0,3,0,2,.000,0,0,,0,2,.000,.000,0,0,,0,2,2,0,0,0,0,0,0
338,Georgios Papagiannis\papagge01,C,20,SAC,5,0,35,8,10,.800,0,0,,8,10,.800,.800,0,0,,2,6,8,2,1,1,1,3,16
339,Tony Parker\parketo01,PG,35,SAS,7,7,131,25,51,.490,0,3,.000,25,48,.521,.490,8,12,.667,2,18,20,32,2,1,10,5,58
340,Chandler Parsons\parsoch01,SF,29,MEM,21,5,433,74,143,.517,35,77,.455,39,66,.591,.640,12,22,.545,8,51,59,41,12,7,21,36,195
341,Patrick Patterson\pattepa01,PF,28,OKC,26,0,359,25,68,.368,17,48,.354,8,20,.400,.493,4,4,1.000,6,43,49,11,16,3,10,28,71
342,Brandon Paul\paulbr01,SG,26,SAS,28,2,329,33,72,.458,12,36,.333,21,36,.583,.542,17,25,.680,2,31,33,27,18,5,17,34,95
343,Chris Paul\paulch01,PG,32,HOU,11,11,334,58,126,.460,23,58,.397,35,68,.515,.552,24,28,.857,6,49,55,104,23,4,21,26,163
344,Elfrid Payton\paytoel01,PG,23,ORL,19,19,531,87,179,.486,12,35,.343,75,144,.521,.520,20,37,.541,20,49,69,123,28,7,48,43,206
345,Gary Payton\paytoga02,PG,25,MIL,9,4,73,8,21,.381,1,8,.125,7,13,.538,.405,0,0,,1,9,10,6,1,0,3,11,17
346,London Perrantes\perralo01,PG,23,CLE,1,0,3,0,1,.000,0,0,,0,1,.000,.000,0,0,,0,0,0,0,0,0,0,1,0
347,Alec Peters\peteral01,PF,22,PHO,2,0,14,1,4,.250,1,4,.250,0,0,,.375,0,0,,0,3,3,0,0,2,0,1,3
348,Mason Plumlee\plumlma01,C,27,DEN,27,5,494,70,125,.560,0,1,.000,70,124,.565,.560,29,73,.397,41,96,137,47,18,25,39,53,169
349,Miles Plumlee\plumlmi01,C,29,ATL,8,5,113,14,26,.538,0,0,,14,26,.538,.538,5,10,.500,9,18,27,4,4,4,10,10,33
350,Jakob Poeltl\poeltja01,C,22,TOR,25,0,405,78,114,.684,1,1,1.000,77,113,.681,.689,18,35,.514,50,60,110,8,9,25,20,57,175
351,Quincy Pondexter\pondequ01,SF,29,CHI,16,1,162,13,43,.302,3,20,.150,10,23,.435,.337,14,17,.824,8,12,20,7,7,2,11,21,43
352,Otto Porter\porteot01,SF,24,WAS,26,26,846,158,316,.500,46,102,.451,112,214,.523,.573,31,38,.816,30,150,180,49,41,13,20,51,393
353,Bobby Portis\portibo01,PF,22,CHI,17,0,364,83,170,.488,20,51,.392,63,119,.529,.547,24,32,.750,30,79,109,27,5,5,21,20,210
354,Kristaps Porzingis\porzikr01,PF,22,NYK,23,23,746,213,459,.464,46,116,.397,167,343,.487,.514,126,149,.846,28,129,157,26,13,50,53,60,598
355,Dwight Powell\poweldw01,C,26,DAL,27,0,479,67,133,.504,9,38,.237,58,95,.611,.538,25,40,.625,42,101,143,26,20,11,18,53,168
356,Norman Powell\powelno01,SG,24,TOR,21,12,434,66,153,.431,22,71,.310,44,82,.537,.503,26,31,.839,4,37,41,38,21,7,30,45,180
357,Alex Poythress\poythal01,PF,24,IND,7,0,20,2,3,.667,2,2,1.000,0,1,.000,1.000,0,0,,0,4,4,0,0,0,1,1,6
358,Jacob Pullen\pulleja01,PG,28,PHI,2,0,2,0,1,.000,0,1,.000,0,0,,.000,0,0,,0,0,0,0,0,0,0,0,0
359,Zhou Qi\qizh01,C,22,HOU,11,0,58,4,20,.200,2,11,.182,2,9,.222,.250,5,6,.833,2,9,11,1,2,6,4,9,15
360,Ivan Rabb\rabbiv01,PF,20,MEM,2,0,3,0,1,.000,0,0,,0,1,.000,.000,0,0,,0,0,0,1,0,0,0,0,0
361,Julius Randle\randlju01,C,23,LAL,26,0,587,124,225,.551,5,24,.208,119,201,.592,.562,70,107,.654,32,130,162,48,12,22,59,93,323
362,Zach Randolph\randoza01,PF,36,SAC,25,24,649,162,317,.511,20,57,.351,142,260,.546,.543,37,48,.771,43,131,174,57,23,4,45,47,381
363,J.J. Redick\redicjj01,SG,33,PHI,25,25,839,145,329,.441,64,164,.390,81,165,.491,.538,70,74,.946,5,62,67,87,16,2,39,59,424
364,Willie Reed\reedwi02,C,27,LAC,21,0,220,44,64,.688,1,1,1.000,43,63,.683,.695,22,35,.629,18,45,63,5,4,8,9,35,111
365,Josh Richardson\richajo01,SF,24,MIA,26,26,840,100,241,.415,39,122,.320,61,119,.513,.496,25,32,.781,16,63,79,50,28,19,55,79,264
366,Malachi Richardson\richama01,SG,22,SAC,12,0,140,15,42,.357,7,18,.389,8,24,.333,.440,10,13,.769,2,9,11,6,6,0,3,14,47
367,Austin Rivers\riverau01,SG,25,LAC,25,23,843,134,331,.405,59,145,.407,75,186,.403,.494,42,65,.646,13,38,51,89,36,5,47,65,369
368,Andre Roberson\roberan03,SF,26,OKC,25,25,662,54,101,.535,7,32,.219,47,69,.681,.569,5,13,.385,46,63,109,26,23,23,24,53,120
369,Rajon Rondo\rondora01,PG,31,NOP,14,13,366,48,99,.485,12,33,.364,36,66,.545,.545,2,2,1.000,7,52,59,117,13,3,31,26,110
370,Derrick Rose\rosede01,PG,29,CLE,7,7,188,39,83,.470,3,13,.231,36,70,.514,.488,19,21,.905,7,11,18,12,2,1,19,11,100
371,Terrence Ross\rosste01,SG,26,ORL,22,20,576,72,177,.407,28,85,.329,44,92,.478,.486,26,35,.743,10,60,70,35,27,10,25,44,198
372,Terry Rozier\roziete01,PG,23,BOS,29,0,681,94,249,.378,47,132,.356,47,117,.402,.472,34,42,.810,21,110,131,59,30,1,20,40,269
373,Ricky Rubio\rubiori01,PG,27,UTA,26,26,751,98,255,.384,29,100,.290,69,155,.445,.441,81,93,.871,13,79,92,128,44,4,80,71,306
374,D'Angelo Russell\russeda01,PG,21,BRK,12,12,333,95,205,.463,18,61,.295,77,144,.535,.507,43,63,.683,9,47,56,68,12,2,48,30,251
375,Domantas Sabonis\sabondo01,PF,21,IND,25,8,615,114,211,.540,5,11,.455,109,200,.545,.552,70,93,.753,67,146,213,53,8,7,50,76,303
376,JaKarr Sampson\sampsja02,SF,24,SAC,6,2,102,13,22,.591,2,3,.667,11,19,.579,.636,2,2,1.000,8,22,30,2,2,4,2,17,30
377,Dario Saric\saricda01,PF,23,PHI,26,21,759,116,278,.417,42,123,.341,74,155,.477,.493,32,40,.800,55,123,178,56,12,9,43,55,306
378,Tomas Satoransky\satorto01,SG,26,WAS,18,0,304,35,73,.479,9,21,.429,26,52,.500,.541,19,27,.704,14,30,44,52,7,0,8,28,98
379,Dennis Schroder\schrode01,PG,24,ATL,25,25,798,201,442,.455,29,91,.319,172,351,.490,.488,73,84,.869,19,51,70,159,27,0,65,48,504
380,Mike Scott\scottmi01,PF,29,WAS,24,0,431,82,149,.550,18,45,.400,64,104,.615,.611,17,24,.708,15,71,86,17,9,5,25,44,199
381,Thabo Sefolosha\sefolth01,SF,33,UTA,26,1,545,78,151,.517,23,56,.411,55,95,.579,.593,28,33,.848,16,96,112,21,38,6,18,35,207
382,Wayne Selden\seldewa01,SG,23,MEM,2,0,19,2,4,.500,1,2,.500,1,2,.500,.625,2,2,1.000,0,2,2,4,1,0,3,0,7
383,Ramon Sessions\sessira01,PG,31,NYK,10,3,149,16,49,.327,2,11,.182,14,38,.368,.347,12,15,.800,1,13,14,27,7,1,14,13,46
384,Iman Shumpert\shumpim01,SG,27,CLE,13,6,271,22,57,.386,7,25,.280,15,32,.469,.447,11,15,.733,7,33,40,17,9,5,17,20,62
385,Pascal Siakam\siakapa01,PF,23,TOR,24,4,490,74,146,.507,9,48,.188,65,98,.663,.538,5,20,.250,26,81,107,43,22,10,21,45,162
386,Ben Simmons\simmobe01,PG,21,PHI,26,26,942,190,377,.504,0,8,.000,190,369,.515,.504,76,134,.567,53,178,231,200,53,21,104,67,456
387,Jonathon Simmons\simmojo02,SG,28,ORL,28,9,781,159,325,.489,27,78,.346,132,247,.534,.531,76,102,.745,27,68,95,52,21,4,64,73,421
388,Kobi Simmons\simmoko01,PG,20,MEM,1,0,5,1,1,1.000,0,0,,1,1,1.000,1.000,0,0,,0,0,0,0,0,0,0,1,2
389,Kyle Singler\singlky01,SF,29,OKC,4,0,32,4,12,.333,2,4,.500,2,8,.250,.417,2,5,.400,0,4,4,0,0,0,2,3,12
390,Marcus Smart\smartma01,SG,23,BOS,27,5,818,83,255,.325,35,119,.294,48,136,.353,.394,53,73,.726,21,82,103,138,31,11,69,71,254
391,Dennis Smith\smithde03,PG,20,DAL,23,23,647,132,334,.395,34,111,.306,98,223,.439,.446,33,50,.660,20,73,93,93,19,7,69,45,331
392,Ish Smith\smithis01,PG,29,DET,27,0,539,109,232,.470,4,20,.200,105,212,.495,.478,20,31,.645,9,52,61,106,12,6,29,39,242
393,J.R. Smith\smithjr01,SG,32,CLE,28,25,857,83,215,.386,55,154,.357,28,61,.459,.514,9,15,.600,11,73,84,66,28,1,30,67,230
394,Jason Smith\smithja02,C,31,WAS,10,2,109,11,35,.314,1,14,.071,10,21,.476,.329,8,8,1.000,11,8,19,1,2,6,4,19,31
395,Josh Smith\smithjo03,PF,32,NOP,3,0,12,1,4,.250,0,0,,1,4,.250,.250,0,0,,3,1,4,0,0,0,0,3,2
396,Tony Snell\snellto01,SG,26,MIL,23,21,729,73,139,.525,39,82,.476,34,57,.596,.665,12,16,.750,4,41,45,38,15,8,12,37,197
397,Marreese Speights\speigma01,C,30,ORL,21,0,241,52,134,.388,35,90,.389,17,44,.386,.519,10,16,.625,7,38,45,12,4,6,13,40,149
398,Nik Stauskas\stausni01,SG,24,PHI,6,0,45,1,4,.250,0,1,.000,1,3,.333,.250,2,2,1.000,0,1,1,1,4,0,4,3,4
399,Lance Stephenson\stephla01,SG,27,IND,27,1,592,87,197,.442,18,59,.305,69,138,.500,.487,27,45,.600,23,111,134,73,15,4,39,50,219
400,Julyan Stone\stoneju01,SG,29,CHO,2,0,18,2,4,.500,2,4,.500,0,0,,.750,0,0,,0,5,5,2,2,0,2,3,6
401,Caleb Swanigan\swanica01,PF,20,POR,14,3,129,14,40,.350,1,5,.200,13,35,.371,.363,8,13,.615,12,24,36,9,5,3,11,24,37
402,Jayson Tatum\tatumja01,SF,19,BOS,29,29,887,132,263,.502,46,92,.500,86,171,.503,.589,90,109,.826,23,142,165,37,28,23,35,64,400
403,Isaiah Taylor\taylois01,PG,23,ATL,20,0,324,44,99,.444,8,24,.333,36,75,.480,.485,21,31,.677,5,23,28,43,10,7,21,25,117
404,Jeff Teague\teaguje01,PG,29,MIN,24,24,823,117,266,.440,36,86,.419,81,180,.450,.508,59,72,.819,8,59,67,172,37,8,73,62,329
405,Mirza Teletovic\teletmi01,PF,32,MIL,10,0,159,25,57,.439,21,45,.467,4,12,.333,.623,0,0,,3,20,23,10,4,1,7,14,71
406,Garrett Temple\templga01,SG,31,SAC,26,20,640,68,183,.372,37,98,.378,31,85,.365,.473,22,29,.759,5,50,55,38,27,14,28,53,195
407,Milos Teodosic\teodomi01,PG,30,LAC,3,3,53,8,24,.333,5,16,.313,3,8,.375,.438,2,2,1.000,1,7,8,8,0,1,4,6,23
408,Jason Terry\terryja01,SG,40,MIL,10,0,111,6,19,.316,1,12,.083,5,7,.714,.342,2,2,1.000,0,9,9,6,7,4,4,7,15
409,Daniel Theis\theisda01,C,25,BOS,27,2,334,47,90,.522,3,18,.167,44,72,.611,.539,21,27,.778,36,71,107,14,12,20,32,61,118
410,Lance Thomas\thomala01,PF,29,NYK,24,4,403,34,87,.391,11,34,.324,23,53,.434,.454,24,30,.800,18,44,62,10,8,0,17,40,103
411,Klay Thompson\thompkl01,SG,27,GSW,28,28,938,227,451,.503,96,209,.459,131,242,.541,.610,30,34,.882,13,104,117,74,19,18,46,51,580
412,Tristan Thompson\thomptr01,C,26,CLE,9,5,179,15,26,.577,0,0,,15,26,.577,.577,5,11,.455,17,34,51,3,1,4,6,16,35
413,Sindarius Thornwell\thornsi01,SG,23,LAC,25,7,412,38,89,.427,11,28,.393,27,61,.443,.489,16,25,.640,10,26,36,17,15,9,19,56,103
414,Anthony Tolliver\tollian01,PF,32,DET,24,1,449,51,123,.415,35,96,.365,16,27,.593,.557,23,31,.742,14,51,65,25,11,7,15,43,160
415,Karl-Anthony Towns\townska01,C,22,MIN,28,28,991,211,402,.525,35,98,.357,176,304,.579,.568,105,124,.847,77,252,329,48,23,37,63,100,562
416,P.J. Tucker\tuckepj01,SF,32,HOU,25,2,676,52,125,.416,33,89,.371,19,36,.528,.548,20,25,.800,27,119,146,22,31,6,29,70,157
417,Evan Turner\turneev01,SF,29,POR,26,3,681,76,197,.386,8,42,.190,68,155,.439,.406,38,44,.864,10,87,97,60,20,10,44,59,198
418,Myles Turner\turnemy01,C,21,IND,20,19,597,113,227,.498,18,51,.353,95,176,.540,.537,44,57,.772,20,127,147,33,7,48,29,55,288
419,Ekpe Udoh\udohek01,C,30,UTA,25,0,359,24,51,.471,0,0,,24,51,.471,.471,16,20,.800,30,26,56,29,16,33,10,51,64
420,Tyler Ulis\ulisty01,PG,22,PHO,28,16,665,85,218,.390,12,46,.261,73,172,.424,.417,43,53,.811,5,45,50,115,28,2,56,42,225
421,Jonas Valanciunas\valanjo01,C,25,TOR,21,21,432,86,151,.570,3,7,.429,83,144,.576,.579,47,52,.904,46,112,158,13,7,11,32,57,222
422,Denzel Valentine\valende01,SG,24,CHI,26,15,747,90,244,.369,52,135,.385,38,109,.349,.475,6,9,.667,20,118,138,77,21,3,26,53,238
423,Fred VanVleet\vanvlfr01,PG,23,TOR,25,0,428,58,147,.395,21,63,.333,37,84,.440,.466,21,25,.840,5,36,41,73,21,6,22,37,158
424,Rashad Vaughn\vaughra01,SG,21,MIL,13,0,109,14,33,.424,9,22,.409,5,11,.455,.561,3,4,.750,1,8,9,8,4,2,1,9,40
425,Noah Vonleh\vonleno01,PF,22,POR,19,12,396,38,71,.535,0,0,,38,71,.535,.535,16,21,.762,34,107,141,12,6,10,11,36,92
426,Nikola Vucevic\vucevni01,C,27,ORL,28,28,853,204,407,.501,42,120,.350,162,287,.564,.553,36,44,.818,47,211,258,93,27,33,51,70,486
427,Dwyane Wade\wadedw01,SG,36,CLE,26,3,617,117,252,.464,11,31,.355,106,221,.480,.486,55,79,.696,18,76,94,102,24,22,52,52,300
428,Dion Waiters\waitedi01,SG,26,MIA,24,24,735,134,337,.398,46,146,.315,88,191,.461,.466,36,49,.735,8,50,58,88,19,7,60,51,350
429,Kemba Walker\walkeke02,PG,27,CHO,24,24,849,175,402,.435,58,161,.360,117,241,.485,.507,131,150,.873,13,74,87,148,19,6,49,36,539
430,John Wall\walljo01,PG,27,WAS,16,16,550,111,256,.434,19,60,.317,92,196,.469,.471,84,112,.750,6,48,54,147,17,18,48,34,325
431,Taurean Waller-Prince\princta02,SF,23,ATL,27,27,841,135,299,.452,45,107,.421,90,192,.469,.527,36,48,.750,21,123,144,68,29,15,58,56,351
432,Derrick Walton\waltode01,PG,22,MIA,4,0,12,0,3,.000,0,1,.000,0,2,.000,.000,2,2,1.000,0,2,2,0,1,1,0,0,2
433,T.J. Warren\warretj01,SF,24,PHO,29,29,917,224,462,.485,9,47,.191,215,415,.518,.495,86,113,.761,59,106,165,37,25,20,41,64,543
434,Briante Weber\weberbr01,PG,25,HOU,4,0,14,0,0,,0,0,,0,0,,,0,0,,0,3,3,1,1,0,1,1,0
435,David West\westda01,C,37,GSW,26,0,325,79,119,.664,3,6,.500,76,113,.673,.676,17,26,.654,20,67,87,41,16,32,28,37,178
436,Russell Westbrook\westbru01,PG,29,OKC,26,26,935,209,528,.396,47,151,.311,162,377,.430,.440,134,184,.728,40,196,236,254,52,3,123,73,599
437,Derrick White\whitede01,PG,23,SAS,6,0,47,3,7,.429,0,0,,3,7,.429,.429,3,6,.500,2,7,9,3,3,2,3,5,9
438,Okaro White\whiteok01,PF,25,MIA,6,4,80,7,16,.438,4,11,.364,3,5,.600,.563,2,3,.667,3,8,11,2,1,1,1,6,20
439,Isaiah Whitehead\whiteis01,PG,22,BRK,9,0,109,25,53,.472,3,9,.333,22,44,.500,.500,10,15,.667,3,15,18,15,5,2,18,14,63
440,Hassan Whiteside\whiteha01,C,28,MIA,15,15,402,93,160,.581,2,2,1.000,91,158,.576,.588,36,52,.692,42,149,191,6,14,24,23,32,224
441,Andrew Wiggins\wiggian01,SF,22,MIN,28,28,1035,192,441,.435,36,121,.298,156,320,.488,.476,92,145,.634,32,82,114,52,34,17,53,51,512
442,Jacob Wiley\wileyja01,PF,23,BRK,5,0,33,1,4,.250,1,2,.500,0,2,.000,.375,1,2,.500,2,9,11,2,1,0,0,4,4
443,Damien Wilkins\wilkida02,SF,38,IND,14,0,89,8,19,.421,0,8,.000,8,11,.727,.421,1,2,.500,4,6,10,6,2,0,4,5,17
444,C.J. Williams\willicj01,SG,27,LAC,13,1,127,14,32,.438,4,9,.444,10,23,.435,.500,3,4,.750,3,10,13,12,4,0,4,6,35
445,Lou Williams\willilo02,SG,31,LAC,25,5,763,163,363,.449,61,154,.396,102,209,.488,.533,103,115,.896,13,55,68,118,23,4,66,36,490
446,Marvin Williams\willima02,PF,31,CHO,26,26,692,88,184,.478,44,96,.458,44,88,.500,.598,33,39,.846,26,92,118,30,19,9,14,40,253
447,Troy Williams\willitr02,SF,23,HOU,4,0,17,2,9,.222,0,5,.000,2,4,.500,.222,1,3,.333,1,3,4,1,1,0,1,2,5
448,D.J. Wilson\wilsodj01,PF,21,MIL,10,0,35,4,9,.444,0,3,.000,4,6,.667,.444,0,0,,0,5,5,1,0,0,1,3,8
449,Jamil Wilson\wilsoja02,SF,27,LAC,7,2,87,11,25,.440,8,21,.381,3,4,.750,.600,0,0,,3,7,10,5,0,0,3,9,30
450,Justise Winslow\winslju01,SF,21,MIA,26,15,603,72,169,.426,16,41,.390,56,128,.438,.473,17,26,.654,26,119,145,49,18,10,27,47,177
451,Jeff Withey\witheje01,C,27,DAL,9,0,36,5,14,.357,2,9,.222,3,5,.600,.429,1,2,.500,1,8,9,0,0,3,2,3,13
452,Nate Wolters\woltena01,PG,26,UTA,4,0,11,0,3,.000,0,0,,0,3,.000,.000,0,0,,1,1,2,1,0,0,0,1,0
453,Brandan Wright\wrighbr03,PF,30,MEM,16,0,229,35,63,.556,0,0,,35,63,.556,.556,15,23,.652,20,35,55,5,8,18,3,16,85
454,Delon Wright\wrighde01,PG,25,TOR,14,0,292,34,65,.523,8,28,.286,26,37,.703,.585,30,32,.938,6,28,34,37,13,5,25,20,106
455,Guerschon Yabusele\yabusgu01,PF,22,BOS,9,0,46,6,16,.375,3,10,.300,3,6,.500,.469,2,2,1.000,8,7,15,4,0,1,3,6,17
456,Joe Young\youngjo01,PG,25,IND,15,0,88,17,38,.447,1,11,.091,16,27,.593,.461,6,10,.600,3,8,11,8,1,0,6,8,41
457,Nick Young\youngni01,SG,32,GSW,27,0,353,63,138,.457,41,99,.414,22,39,.564,.605,16,24,.667,4,30,34,13,13,2,14,24,183
458,Thaddeus Young\youngth01,PF,29,IND,27,27,906,161,324,.497,31,85,.365,130,239,.544,.545,10,18,.556,56,110,166,53,45,11,35,59,363
459,Cody Zeller\zelleco01,C,25,CHO,19,0,378,47,95,.495,1,1,1.000,46,94,.489,.500,42,58,.724,46,59,105,16,9,21,21,52,137
460,Tyler Zeller\zellety01,C,28,BRK,18,10,339,65,106,.613,3,10,.300,62,96,.646,.627,24,39,.615,28,57,85,12,7,11,22,35,157
461,Paul Zipser\zipsepa01,SF,23,CHI,23,7,380,38,116,.328,14,47,.298,24,69,.348,.388,4,8,.500,5,68,73,25,10,4,20,34,94
462,Ante Zizic\zizican01,C,21,CLE,11,1,39,4,11,.364,0,0,,4,11,.364,.364,5,7,.714,5,8,13,1,0,3,2,4,13
463,Ivica Zubac\zubaciv01,C,20,LAL,6,0,14,2,5,.400,0,0,,2,5,.400,.400,0,0,,2,2,4,0,0,0,2,2,4